[
  {
    "level": 1,
    "grid": [
      [ 0, 0, 0, 0, 0, 0, 0, 0 ],
      [ 0, 1, 1, 3, 1, 1, 2, 0 ],
      [ 0, 1, 1, 5, 1, 1, 1, 0 ],
      [ 0, 1, 1, 1, 1, 1, 1, 0 ],
      [ 0, 2, 1, 1, 1, 3, 1, 0 ],
      [ 0, 0, 0, 0, 0, 0, 0, 0 ]
    ]
  },
  {
    "level": 2,
    "grid": [
      [ 1, 0, 0, 0, 0, 0 ],
      [ 0, 0, 1, 1, 2, 0 ],
      [ 0, 1, 1, 1, 1, 0 ],
      [ 0, 1, 3, 3, 1, 0 ],
      [ 0, 1, 5, 2, 0, 0 ],
      [ 0, 0, 0, 0, 0, 1 ]
    ]
  },
  {
    "level": 3,
    "grid": [
      [ 0, 0, 0, 0, 0, 1, 1 ],
      [ 0, 1, 1, 1, 0, 0, 0 ],
      [ 0, 2, 2, 3, 3, 2, 0 ],
      [ 0, 1, 3, 3, 5, 1, 0 ],
      [ 0, 1, 1, 1, 2, 1, 0 ],
      [ 0, 0, 0, 0, 0, 0, 0 ]
    ]
  },
  {
    "level": 4,
    "grid": [
      [ 0, 0, 0, 0, 0, 0 ],
      [ 0, 1, 2, 0, 0, 0 ],
      [ 0, 1, 1, 0, 0, 0 ],
      [ 0, 4, 5, 1, 1, 0 ],
      [ 0, 1, 1, 3, 1, 0 ],
      [ 0, 1, 1, 1, 1, 0 ],
      [ 0, 0, 0, 0, 0, 0 ]
    ]
  },
  {
    "level": 5,
    "grid": [
      [ 0, 0, 0, 0, 0, 0, 0 ],
      [ 0, 0, 1, 1, 0, 0, 0 ],
      [ 0, 1, 1, 1, 1, 1, 0 ],
      [ 0, 2, 4, 4, 3, 5, 0 ],
      [ 0, 1, 1, 1, 0, 0, 0 ],
      [ 0, 0, 1, 1, 0, 0, 0 ],
      [ 0, 0, 0, 0, 0, 0, 0 ]
      
    ]
  },
  {
    "level": 6,
    "grid": [
      [ 1, 0, 0, 0, 0, 0, 1 ],
      [ 0, 0, 1, 1, 1, 0, 1 ],
      [ 0, 1, 1, 1, 1, 0, 1 ],
      [ 0, 1, 2, 3, 2, 0, 0 ],
      [ 0, 0, 3, 0, 3, 1, 0 ],
      [ 1, 0, 2, 3, 2, 1, 0 ],
      [ 1, 0, 1, 1, 1, 1, 0 ],
      [ 1, 0, 1, 5, 1, 0, 0 ],
      [ 1, 0, 0, 0, 0, 0, 1 ]
    ]
  },
  {
    "level": 7,
    "grid": [
      [ 0, 0, 0, 0, 1, 1, 1, 1 ],
      [ 0, 1, 1, 0, 1, 1, 1, 1 ],
      [ 0, 1, 1, 0, 0, 0, 0, 0 ],
      [ 0, 1, 3, 3, 1, 3, 1, 0 ],
      [ 0, 1, 2, 2, 1, 2, 1, 0 ],
      [ 0, 0, 1, 1, 0, 0, 0, 0 ],
      [ 1, 0, 5, 1, 0, 1, 1, 1 ],
      [ 1, 0, 0, 0, 0, 1, 1, 1 ]
    ]
  },
  {
    "level": 8,
    "grid": [
      [ 1, 1, 1, 0, 0, 0, 1, 1, 0, 0, 0, 0, 0 ],
      [ 0, 0, 0, 0, 1, 0, 0, 0, 0, 1, 1, 1, 0 ],
      [ 0, 1, 1, 0, 0, 0, 1, 1, 1, 1, 1, 1, 0 ],
      [ 0, 1, 2, 2, 1, 1, 3, 3, 3, 3, 1, 1, 0 ],
      [ 0, 1, 2, 2, 1, 1, 0, 1, 5, 0, 1, 1, 0 ],
      [ 0, 0, 0, 0, 0, 0, 0, 0, 0, 0, 0, 0, 0 ]
    ]
  },
  {
    "level": 9,
    "grid": [
      [ 1, 0, 0, 0, 0, 0, 1, 1 ],
      [ 1, 0, 1, 5, 1, 0, 0, 0 ],
      [ 1, 0, 1, 0, 1, 1, 1, 0 ],
      [ 0, 0, 3, 2, 4, 0, 1, 0 ],
      [ 0, 1, 3, 2, 4, 1, 1, 0 ],
      [ 0, 1, 1, 1, 1, 1, 1, 0 ],
      [ 0, 1, 0, 1, 1, 0, 0, 0 ],
      [ 0, 1, 1, 1, 1, 0, 1, 1 ],
      [ 0, 0, 0, 0, 0, 0, 1, 1 ]
    ]
  }
]